################
#X             #
#              #
#             #
#O           #
#############
