  ###
 #   #####
#  X      #
#O######  X#
#   #       #
# X     #  #
 #   P  #  O#
  ##########
