#########
#     P #
#   XX  ###
#   O     ####
######       #
     ##  O####
      #####
